GGGGGGGGWWWWWGGGGGGG
GGGWGGWGWGWGWGGWGGGG
GGGWGGGGGGGGGGGGGGGG
GGGGGGGGWWGGGGGGGGGG
GGGGGGGGGGGGWWGGGGGG
WWWWWWWGGWWWWGWWWWGG
GGGGGGWWGGGGWWWWWWGG
WWWGGGGGGGGGGGGGGGGG
GGGGGGGWWGGGGWWGGGGG
GGGGGGGGGGGGGGGGGGGG
GGGWWGGGGGWWGGGWWGGG
GGWWGGGGGGGGWGGGGGGG